11111111111111111111111111111111111111111111111111111111111111111111
11111111111111111111111111111011111111111111110111111111111111101111
11111011111111111111110001110001111111100011100011111111000111000111
11100000001001111111000000010001111110000000100011111100000001000111
11100000011000011111000000110000111110000001100001111100000011000011
11100000110000011111000001100000111110000011000001111100000110000011
11001110110000111110011101100001111100111011000011111001110110000111
11001111110011111110011111110101111100111111101011111001111111010111
11001111100111111110011111111101111100111111111011111001111111110111
10001100001110111100011000011101111000110000111011110001100001110111
11100001111100011111000011011000111110000110110001111100001101100011
11100011111100011111000111001000111110001110010001111100011100100011
11101111110001111111111111100011111111111111000111111111111110001111
11100000000001111111000000000011111110000000000111111100000000001111
11110001100001111111100011000011111111000110000111111110001100001111
10000111111111111100001111111111111000011111111111110000111111111111
11111111111111111111111111111111111111111111111111111111111111111111



















































