11111111111111111
10010000111111111
10010000110001111
10111100110001011
10001101110001011
10101101111101011
10101001000001011
11100010001111011
11101000100000011
11101011101101111
11101011001101111
11110010011000111
11100010001000111
11101000001000111
11101101111111111
11111111111111111
