1111111111111111
1001110001111111
1011110001001101
1001110000000000
1100111111100000
1101111101111101
1000000001100001
1000011101100001
1111111101111001
1111111000001100
1111000001100101
1100001001101101
1101101111100001
1101101111101111
1101100111100011
1111111111111111
