11111111111111111
11111111111111111
11111111111111111
11011111111111111
11000001011111111
11111101011111111
11111101011111111
11111100011111111
11111111111111111
11111111111111111
11111111111111111
11111111111111111
11111111111111111
11111111111111111
11111111111111111
11111111111111111
