11111111111111111
10011111111111111
10001111111111111
11000000001111111
11110010000111111
11110011011111111
11110011011111111
11111010011111111
11111000111111111
11111100111111111
11111111111111111
11111111111111111
11111111111111111
11111111111111111
11111111111111111
11111111111111111
