11111111111111111
10000011111111111
11101111111111111
11101111111111111
11100011111111111
11100000111111111
11100110111111111
11111110111111111
11111110111111111
11111110111111111
11111111111111111
11111111111111111
11111111111111111
11111111111111111
11111111111111111
11111111111111111
