11111111111111111
11111111111111111
11111111111111111
11111111111111111
11111111111111111
11111100000011111
11111101011111111
11100000011111111
11111111111111111
11111111111111111
11111111111111111
11111111111111111
11111111111111111
11111111111111111
11111111111111111
11111111111111111
