11111111111111111
11111111111111111
11111111111111111
11000000000111111
11111111110011111
11111111111011111
11111111110011111
11111111110111111
11111111110111111
11111111110111111
11111111110111111
11111111111111111
11111111111111111
11111111111111111
11111111111111111
11111111111111111
