11111111111111111
11111101111111111
11111101111111111
11111010000111111
11111010000111111
11111101111111111
11111101111111111
11111111111111111
11111111111111111
11111111111111111
11111111111111111
11111111111111111
11111111111111111
11111111111111111
11111111111111111
11111111111111111
